#############################################################################################################################################
#...#.....................#.............#...........#.....#.#.........#.............#.......#...#.........#...........#.......#.#.........#E#
#.#.#######.#############.#.#######.#####.#######.#.###.#.#.#.#.#.#####.#####.#####.###.#.###.#.#.#.#####.#######.#.###.###.#.#.#.#####.#.#.#
#.#.......#.#...........................#.....#.#.#.....#...#...#.#.....#...#.....#...#.#...#.#...#.....#.....#...#.#...#...#.#.#.#.#...#.#.#
#.#######.#.#.###.#.###.#.#.#####.#####.#####.#.#.#####.#####.#.###.#####.#.#####.###.#####.#.#########.#####.#.###.#.###.###.#.#.#.#.###.#.#
#...#.......#...#.....#.#.#...#...#...#.....#.#.#...#...#...#.#.....#.....#.#.....#.#.#...#...#.#.......#.......................#...#...#...#
###.#######.###.#######.#.#.#.#.###.###.###.#.#.###.#####.#.#.#############.#.#####.#.#.#.#.#.#.#.#######.#.#.#.#####.#.###.#.#.###.###.#####
#...#.....#...#.........................#.#.#.....#.....#.#.#.#.............#...#...#.#.#.#.....#.#.....#.#...#.#...#.#...#.#...#...#.#.....#
#.#.#.###.#.###.#.#.#####.#.#########.#.#.#.#####.#####.#.#.#.#.###########.###.#.#.#.#.#.###.###.#.#.###.#####.#.#.#.#.#.#.#####.###.#.###.#
#.#.#.#.#.#.#...#.#.#...#.#...#...#...#...#...#...#.#...#.#...#.#.......#...#...#.#.#.#...............#...#.....#.#.#...#.#.#.....#.....#...#
#.#.#.#.#.#.#.###.#.###.#.###.#.#.#.###.#.#.#.#.###.#.###.#####.#.#####.#.###.###.#.#.#.#.#.#.#.#.#.#.#.###.#####.#.#####.#.#.#####.###.#.#.#
#.#.#.#.#.#.#.#...#...#...#...#.#.#.#...#.#...#.....#.....#.....#.#.............................#...#.#.#...#.....#...#...#.....#...#...#.#.#
#.###.#.#.###.###.###.#.#######.#.#.#.#.###.#######.#########.#.###.#.#######.#.#######.###.#####.#.#.#.#.#.#.#####.#.#.#######.#.#####.#.#.#
#.#...#.#...#.#...#...#.........#...#.#.....#.....#.#.........#.#...#...........#...#.....#.#.......#.#.#.#.#.#...#.#.#...#...#...#.......#.#
#.#.###.###.#.#.#.#.#################.#.###.#.###.#.#####.#####.#.###.#########.#.###.###.#.#.#.#.###.#.###.#.#.#.#.#####.#.#.#####.#######.#
#...#.....#.#...#.#.#.....#...#.......#.......#...#...........#.#.#.........#...#.......#.#...#.#.....#...#.....#.#.#.....#.#.......#...#...#
#.#####.#.#.#####.#.#.###.#.#.#.#######.#.#####.###########.###.#.#####.###.###.#########.#####.#########.#######.#.#.#####.###.#######.#.###
#.......#.#.......#.#...#.#.#...#.#.....#...#.......#...#.......#.......#.#...#...#.....#.....#...#.....#.........#.......#.#...#.....#.#...#
#######.#.#########.#####.#.#####.#.#.#####.#.###.###.#.#.###########.###.###.###.#.###.###.#.#.#.#.#.#####.#####.#######.#.#.###.###.#.###.#
#...#...#.......#.#.......#.#.............#.#...#...#.#...#...#.....#.....#...#.....#.....#.#.#.#...#.......#.........#...#.#...#.#...#.....#
#.#.#.#.#.#####.#.#.#.#####.#.#######.###.#.#.###.#.#.#####.#.###.#.#.###.#.###.#.#######.###.#####.#########.#.#####.#.###.#.###.#.###.#####
#.#.#.#.......#...#.#.....#.#...#.....#...#.#.#...#.#...#...#.....#.#.#...#.#.....#.....#...#.#...#.....#.....#.#.....#...#.#.#...#...#.....#
#.#.#.#.#.#.#####.#.#.###.#.###.#.#####.###.###.###.#.#.#.#########.###.#.#.###.###.###.###.#.#.#.###.###.#####.#.#.#######.###.#####.###.#.#
#.#.#.....#.......#.#.........#...#...#.#...#...#...#...#...#.....#.....#.....#...#.#.#.#...#.#.#.#...#.......#.#...#.....#...#.#...#.#...#.#
#.#.###.#.#.#######.#.#######.#####.#.#.#.#.#.###.#.#.#####.#####.#######.###.#.#.#.#.#.###.#.#.#.#.###.#######.###.#.###.###.#.#.###.#.#.###
#.#.....#.#.....#.#.#.#.....#.......#.#.#.#.#.#...#.#.....#.......#.....#.#.#.#...#...#...#...#.#.#...#.#.#...#...#...#.#.....#...#...#.#...#
#.#####.#.#.###.#.#.###.###.#########.###.#.#.#.###.#####.###.#.#.#.#.###.#.#.###.###.###.#.###.#.###.#.#.#.#.###.#####.###.#.###.#.###.#.#.#
#...#.....#.#.....#.#.....#.#...#.........#.#.#...#.#...#...#.#.....#.....#.#.#...#...#.#.#.#...#...#.#...#.#.....#.........#.....#.......#.#
#.#.#.#.#.#.###.###.#.#####.#.#.###########.#.###.#.#.#.###.#.#.###########.#.#.###.###.#.###.#####.#####.#.#.#########.#################.#.#
#.#...#.......#.#...#.#.....#.#.#.....#.....#...#.#...#.#...#.#.#.....#.....#.#...#...#.#...#.#...#.....#.#.#.#...#...#.....#...........#...#
#.#.###.#.#.#.#.#.###.#.#.###.#.#.###.#.#######.#.#####.#.###.#.###.#.#.#.#.#.###.###.#.###.#.#.#.###.###.#.###.#.#.#.#####.#.#########.#.#.#
#...#...#.#...#.#.......#.#...#...#.#.#...#.....#.....#.#.#...#.....#.#.#.#.#...#...#...#.......#.#.#.....#.#...#...#...#.#.......#.....#.#.#
###.#.#.###.#############.#.#######.#.###.###.#.#####.###.###.#.#####.###.#####.###.###.#.#.#####.#.#######.#.#########.#.#######.#.#####.###
#.#.#.#...#.......#...#...#.#.......#...#.....#.....#.....#...#...........#.....#.#.#...#.#...#...#...#.....#.#.....#...#...................#
#.#.#.#.#.#.#####.#.#.#.#.#.###.#.#.###.#########.#.#######.###.###########.#####.#.#.###.#####.###.#.#.#####.###.#.#.#.#######.###.#.###.#.#
#.#.#.#...#.....#...#.#.#.#...#.#...#.#...#.....#.#.........#.......#...#...#.......#.#.#.......#...#.#.....#...#.#.#.#.#.....#...#.#.#...#.#
#.#.#.#.###.###.#.###.#.#####.#.#.#.#.###.#.#.#.#.#######.#######.###.#.#.###.#.#####.#.#########.###.#####.###.#.#.#.#.#.###.###.#.#.#.#.#.#
#.#.#.#.#...#...#.#...#.....#.#.#.#.....#...#.#.#.......#.......#.#...#.#...#...#...#.........#...#.#.#...#...#...#.#.#.#...#.#...#...#...#.#
#.#.#.#.###.#.###.#.#.#####.#.#.#.###########.#.#######.#.#####.#.#.###.###.#.#.#.###.#######.#.###.#.###.###.#####.#.###.###.#.###.#.###.#.#
#...#.#.....#.#...#.#...#.#...#.#...........#.#.....#.#.#...#.#.#.#...#.....#.....#.......#...#...#.#...#...#.......#...#.#...#.#...#...#...#
#.###.#######.#####.###.#.#####.#####.#####.#.#####.#.#.###.#.#.#.###.#####.#######.#####.#.#####.#.###.#.###########.#.#.#.###.#.#####.#.#.#
#...#.....#...#.....#.#.....#.#.......#.....#.#...#...#.#...#.#.#...#.....#.#.........#...#.#.....#.......#.........#.#...#...#...#.......#.#
###.#.###.#.###.#####.#####.#.#.#.#####.#####.###.###.#.###.#.#.#.#######.###.#########.###.#.###########.#.#######.#####.###.#.#########.#.#
#...#...#.#...#...#.....#...#.#.#...#...#.....#...#...#...#...#.........#.....#.........#.....#.........#...#.....#.#...#...#.#.#.....#...#.#
#.#####.#.###.###.#.#.#.#.###.#.###.#.###.#####.#.#.###.#.###.#########.#######.###.#.###.#####.#######.###.#.###.#.#.#.#####.#.#.###.###.#.#
#.....#.#.#.......#.#...#.#.........#...#.......#.#...#...#...#.........#.........#.#.....#.....#.#...#...#.#...#.#.#.#.#.....#...#.#...#.#.#
#####.###.#########.###.#.###.#####.#.#.#.#.#.#######.#.#####.#.#.#.###.###.#####.#.###.#.#.#####.#.#.###.#.#.#.#.#.#.#.#.#########.###.#.#.#
#.....#...#.......#...#.#.#...#.....#.#.#.#.#.........#.....#...#.....#...#...#...#.......#.#.......#...#.#.#.#.#.#.#.#...#...........#.#.#.#
#.#####.###.#####.#####.#.#.#.#.###.###.#.#####.###########.#######.#.#.#.#.#.#####.#######.#.#####.#.###.#.#.#.#.#.#.#######.#.#####.#.###.#
#.....#.....#...#...#...#.#.#...#...#...#.#...#...#...#.....#.....#.#.#.....#...#...#.....#...#...#.#...#...#.#.#.#.#.......#.#.#.....#.#...#
#####.#######.#.#.#.#.#.#.#.#####.###.###.#.#.###.###.#.#####.###.#.#.#########.#.#.#.###.###.#.#.#####.###.#.#.#.#.#######.###.#####.#.#.###
#...#.#.......#.#.#.#.#.#...#.....#.#...#...#.#.......#.......#...#.#.#.......#.#.#.#...#...#...#.#.........#.#.#...#.....#...#.....#.#.#...#
#.#.#.#.#######.###.#.#######.#.###.#.#.#####.#################.#####.#.#####.#.#.#.###.###.###.#.#.#####.###.#.###.#.###.#.#.#.###.#.#.###.#
#.#...#.#...#.....#.#.......#...#...#.#.....#.#.........#.....#.......#.......#...#...#.#.#...#.#.#.......#...#...#.#.#...#.#.#.#...#.#.#...#
#.#####.#.#.#####.#.###.###.#.#.#.#.#.#.#####.#.#######.#.#.#####.#####.#.#####.#####.#.#.###.#.#.#.#######.#####.#.#.#.###.#.###.###.#.#.###
#.................#...#.#.....#.#.#.#.#.....#...#.....#...#.....#.#.....#.#.#...#...#.#...#.#.#.#.#...#.....#...#.#...#.....#...#.#...#.#...#
#####.#.###.#.#.###.#.#.#####.#.###.#.#####.#####.#.#.#########.#.#.#####.#.#.###.#.#.###.#.#.#.#.###.#.#####.###.#########.###.#.#.###.###.#
#...#.#.#...#.#...#.#.#.#...#.#...#.....#.#.......#.#.........#...#.#...#.#...#...#.#...#.#...#.#.#...#.....#...#...#...#...#...#.#...#...#.#
###.#.#.###.#.###.#.#.#.#.#.#####.#.###.#.#########.###.#.#########.#.###.###.#.###.#.###.#.#.###.#########.###.###.#.#.#.###.###.###.###.#.#
#...#.#.....#.#...#.#.#.#.#.....#.#.........#.....#...#...#...#.....#...#...#.#.#.#.#.#...#.#...#.............#...#.#.#.....#.....#.....#.#.#
#.###.#.#####.#.#####.#.#.###.###.#########.#.#.#.###.#####.#.#.#######.###.###.#.#.###.###.###.#############.###.#.#######.#.#.#######.#.#.#
#...#.#...#...#.........#...#...#.......#...#.#.#.#...#.....#...#...#.....#.#...#.#...#.......#.......#...#.......#.......#...#.......#.#.#.#
#.#.#.#.#.#.###########.#.#####.#######.#####.#.#.#.#.#.#########.#.#.#.###.#.###.###.#######.#######.#.#.#######.#####.#.#########.#.###.#.#
#.#.#...#.#.#...........#.#.....#.....#.#.......#.#.#.#.......#...#...#.#...#...#...#.......#.#...#...#.#.......#.#...#.#.#.......#.#.....#.#
###.###.#.#.#.#.#.###.#.#.#.#####.###.#.#.#####.#.#.#########.#.#########.#.###.###.#####.###.###.#.###.#######.###.#.###.#.#####.#.#.#####.#
#.....#...#...#.#.#...#.#.#.....#.#.#...#.#...#...#.#.....#...#...#...#...#...#.......#.#...#.....#.#.....#.....#...#.....#.#...#.#.#.......#
#.#####.#####.#.###.#.###.#####.#.#.#####.###.#.###.#.###.#.#####.#.#.#.#.#.#########.#.###.#####.#.###.#.###.#.#.#######.#.#.###.#.#.#.###.#
#.................#.#.....#...#.#.#.......#...#.....#.#.#...#...#.#.#...#.#.........#...#.#.......#...#.#...#...#.#...........#...#.....#.#.#
#.#.###.#.#.###.#.#.#.#####.###.#.#.#####.#.#.###.###.#.#####.#.#.#.#######.#######.###.#.###.#######.#.###.###.#.#.#######.###.#####.###.#.#
#.#.....#.#...#.#.#.#.#.......#...#.......#.#.#...............#...#.......#.#.....#.#...#...........#.#...#...#.....#...........#.#.........#
#.#####.#.###.#.#.#.#.#.#####.#########.#.#.#.#.###.#######.#####.#######.#.#####.#.#.###.#.#########.#######.#.#.###.#####.#.###.#.#.#######
#.....#.#.#.#.#.#.#...#...#.........#...#.#.#.#.#.#.........#...#.....#.#.#.#...#.#.#...#...........#.#.......#.#.#...#.....#.......#.#.....#
#.#.###.#.#.#.###.#.#.#####.#########.#.#.#.###.#.###.#######.#.#####.#.#.#.#.#.#.#.###.###########.#.#.#######.#.#.#####.###.#######.#.###.#
#.#...#...#...#...#...#...#...#.....#...#.#...........#.......#.#.....#.#.#...#...#.#...#.............#...#.#...#.#.....#.....#...#.......#.#
#.###.#.###.###.#####.#.#.###.#.###.#.###.#.#########.#.###.#####.#####.#.###.#.#.#.#.###.#########.#.#.#.#.#.#########.#.#####.###.#######.#
#.#.......#.#...#...#.#.#.....#.#.#.#.#...#.#...............#.....#...#.#...........#.....#...#...#.#.#.#.#.............#.#...........#...#.#
#.#.#######.#.#.#.###.#.#.#####.#.#.#.#.#####.#.#############.#####.#.#.#####.###.#.#####.#.#.#.#.#.#.#.#.###############.#############.#.#.#
#.#.....#...#.#.#...#.#.#.#...........#.......#.#.......#...#.#.....#.#...#...#...#.......#.#...#...#.#.#...#.....#.#...#...#.....#...#.#.#.#
#######.#.#.#.#.###.#.#.###.#########.#########.#.#####.#.#.#.#.###.#####.#.#.#.#####.#.#.#.#########.#.###.#.#.#.#.#.#.###.#.###.#.#.#.#.#.#
#.......#.#...#...#...#...#.#.......#.#.......#.#.....#.#.....#...#...#.....#.#.#...#.#.......#.......#.....#.#.#.....#...#...#.#...#...#.#.#
#.#####.#.#.#####.#.###.#.#.#.#####.###.#####.#.#####.#.#.#####.#####.#.###.#.###.#.###########.#######.#.#####.#####.###.#####.#########.#.#
#.#...#.#.........#.#...#...#...#.#.#...#...#.#.#.....#.#.#.#...#...#.#.#...#.#...#.....#.......#.....#.#.#...#.......#.#...#.........#.#...#
#.#.#.#.###.#######.#########.#.#.#.#.#.#.###.#.#.###.#.#.#.#.###.#.#.#.#.###.#.#######.#.#####.#.###.#.#.#.#.#.#######.#.###.###.###.#.###.#
#...#.#...........#.....#...#.#.#.....#...#...#.#.#...#...#.#.#.#.#...#...#...#.#.......#.#.....#...#.#.#...#.#.#.......#.....#.#...#.#...#.#
#.###.#####.#####.#.###.#.#.#.#.#########.#.###.#.#.###.###.#.#.#.###.#####.###.###.#####.###.#.#.#.#.#######.#.###.###########.###.#.#.#.#.#
#.#...#.#...#...#...#.#.#.#.#.#.....#.....#.#...#.#.....#...#...#.#.......#.#.....#.....#.#...#.#.#.#.....#...#...#.........#...#...#...#.#.#
###.###.#.#.#.#.###.#.#.#.#.###.###.#.#####.#.#.#.###.###.#.#.#.#.#######.#.###.#.#####.#.#.#####.#.#####.#.#####.#####.###.#.#.#.#########.#
#...#.....#...#.....#.#...#...#...#.......#.#...#...#...#.#.#.....#...#...#...#.#.#...#...#.#...#.#.#.......#...........#.....#.#.....#.....#
#.###.#####.#########.#######.###.#.#.###.#.###.###.###.#.#.#.###.#.#.###.###.#.#.#.#.#####.#.#.#.#.#################################.#.#####
#.#.....#...........#.......#.#...#.#.#.#...#.....#...#.#.#.#...#...#...#.....#...#.#...#.....#.#.#.#.....................#.........#.......#
#.#####.#.#.#######.#.#.#####.###.#.#.#.#####.#.#####.#.#.#.###.#######.###.#.###.#.#####.#####.#.#.#.#####.#############.#.###.###.#########
#.#...#...#...........#.....#...#.#.#.#.......#.......#...#...#.#.#.....#...#.....#...#.....#...#.#.......#.....#.......#.#.................#
#.#.#.#################.###.###.#.#.#.#.#####.#.#######.###.###.#.#.#########.#####.#.#.#####.###.#####.#.#####.#.###.#.#.###.#.#####.###.#.#
#...#.........#.........#.#...#.#.#.....#.....#...#.......#.#...#.#.................#.#...#...#...#...#.#.....#.#.#...#.....#.#.......#.....#
#######.#####.#.#########.###.#.#.#.#########.###.#.#######.#.###.###.#.#############.###.#.###.###.###.#####.#.###.###.###.#.#########.#####
#.....#.#.....#.#.........#.#...#.#.....#...#...#.#.#...#...#.......#.#.#.#.........#.....#.....#.....#.#.....#.....#...#...#.........#.....#
#.###.###.###.#.#######.#.#.#########.#.#.#.#.#.#.#.###.#.###.#####.#.#.#.#.#.#####.#################.#.###.#####.###.#.#######.#.#########.#
#...#.....#.#.#...............#.....#.#...#.#...#.#...#.#.#.......#.#...#...#.#...#.....#.#.........#.#...#.....#.#.....#.....#...#.....#...#
###.#######.#.###############.###.#.#.#####.#####.###.#.#.#.#####.#.#####.###.#.#.#####.#.#.###.###.#.###.###.#.#.#.###.#.###.#.###.###.#.#.#
#...#.....#...#.....#.......#.....#.#.#.....#...#...#...#.......#...#.......#.#.......#.#.....#...#.....#.#...#.#.#...#.#...#...#...#.....#.#
#.###.#.###.###.#.#.###.###########.###.#####.#.###.###.#######.#########.###.#######.#.#########.###.###.#.###.#####.###.#.#####.#######.#.#
#...#.#.....#...#...#...#.........#...........#.....#.#.#.......#.......#.#...#.....#.........#...#...#...#...#.......#...#.....#.......#...#
###.#.#########.#.###.#.#.###.#.#.###.###.###########.#.#.#.###.#.#####.###.#.#.###.#.###.###.#.###.###.#####.###.#####.#####.#########.#.###
#...#.......#...#.....#.#...#...#...#.#...#...#.......#.#.#.#.....#...#.....#...#...#.#.....#...#.#...#.#...#...#.#...#.#...#.....#.....#.#.#
#.#########.#.#.#####.###.#######.###.#.###.#.#.#.#####.#.#.#######.#.#######.###.###.#.###.#####.###.#.#.#.###.#.#.#.#.#.#.###.#.#.#####.#.#
#.........#...#.#.....#...#.....#.....#.#...#...#.#.......#.#.......#.......#.#.....#.#...#...#.#.....#...#.#...#.#.#.#.#.#.................#
#.#.#.#.#.#######.###.#.###.###.###.###.###.#.#####.#####.#.#.#########.###.#.#####.#.###.#.#.#.#.#########.#.#.#.#.#.#.#.#######.#####.###.#
#...#.#.#...........#.#.#...#.#...#...#.#...#.#.....#.....#...#...#...#...#.#.....#.#.....#...#...#...#.....#.#.#.#.#...#.....#...#.........#
#.###.#.#############.#.#.###.###.#####.#.#####.#####.#.#.#####.#.#.#.#####.#####.#.###.#.#.###.###.#.#.#####.###.#.#########.#####.#####.###
#...#.#.#.....#.#.....#.#.#.....#.#.....#.#.....#.....#.#.#...#.#.#.#.........#...#.#...#.#.#...#...#.#.#...#.....#...#.....#...............#
###.#.#.#.#.#.#.#.###.#.#.#####.#.#.#####.#.#####.###.#.#.#.#.#.###.#####.#####.###.#.###.#.#####.###.#.#.#.#.#######.###.#.#.###.#.#.#.###.#
#.#.#...#.#.#.#.#...#.#.#.......#...#.....#...#.....#.#.#.#.#...#...#...#.#.....#.#.....#.#.#...#...#.#...#.........#.....#.#.#...#.#...#...#
#.#.#######.#.#.###.#.#.#######.#####.#.#####.#.#.#.#.#.#.#.###.#.#####.#.#.#####.#.###.#.#.#.#.###.#.#.#.#################.###.#.#.###.#.#.#
#.#.#.......#.#.#...#.#.#...#...#.#...#.....#.#.#.#...#.#...#...#.....#...#.#...........#.#.#.#.#...#.#.#.................#.....#.#...#.#.#.#
#.#.###.#####.#.#.#####.#.###.###.#.#######.#.###.#####.#########.###.#.###.#####.###.###.#.#.#.#.###.#############.#####.###.#######.#.#.#.#
#.#.....#...#.#.#.......#.#...#.....#...#...#.........#...#.....#.#...#...#...#.....#.....#...#.#.#.........#.....#.....#.....#...#...#.#.#.#
#.#######.###.#.#########.#.#####.#####.#.#########.#####.#.###.#.#.#########.#.###.#.#########.#.###.#####.#.###.###.###.#####.#.#.###.#.#.#
#.........#...#.......#...#.....#.......#.........#.....#.....#.#.#...#...#...#...#...........#.#.....#...#.#.#...#...#...#.....#.#.#...#.#.#
#.#####.###.###.###.#.#.#######.#######.###.#####.#####.#####.#.#####.#.#.#.#####.#######.#####.#####.#.#.#.#.#.#######.#.#.#####.#.###.#.#.#
#...#.#...#.#...#...#.#.......#.#.#.....#...#...#.....#.......#.#...#.#.#.#.....#.#.....#.#...#.......#.#.#...#.#.......#...#.....#...#...#.#
###.#.###.#.#.#.#.###.###.###.#.#.#.#.###.###.#.#####.###.###.#.#.#.#.#.#.#.###.#.#.#.###.#.#.#########.#######.#.#.#########.#####.#.#######
#.....#...#.#...#.#.#.....#...#.#...#...#.....#.....#.....#.....#.#...#.#.#...#.#.#.#.....#.#.......#.........#.#.#.#.#.....#.....#.#.......#
#######.###.#.###.#.###.#####.#.#.###.#.###########.#######.###.#.#####.#.#####.#.###.#####.#######.#.#####.#.#.###.#.#.#.#######.#.#######.#
#.....#.#...#...#.#.....#...#.#.#.#...#.....#...#...#...#...#.......#...#.......#...#.#.#...#.........#...#.#.#.....#.#.#.....#...#.#.#...#.#
#.###.#.#.#####.#.#.#####.#.###.#.#######.#.###.#.###.#.#.#########.#.#.#########.#.#.#.#.#.#####.#####.###.#########.#.#####.#.###.#.#.#.#.#
#.#.....#.....#.#.#...#.....#...#.........#.#...#...#.#.......#.....#.#.#.......#.#.#...#.#...............#.......#...#.#.#...#.#.....#.#.#.#
#.###########.#.#.###.#.###.#.#############.#.#.###.#.#######.#.###.#.#.#.#####.###.###.#.###.#.#####.###.#######.#.#.#.#.#.###.#######.#.#.#
#...#.......#.#.#.#.#.#.#.#...#.........#...#.#.#.#...#...#.....#.#.#.#.#.#...#...#.#...#.....#.....#...#...#...#...#.#...#...#.......#.#.#.#
###.#.###.###.#.#.#.#.#.#.#####.###.###.#.###.#.#.#####.#.#######.#.#.###.#.#####.#.#.#########.###.###.#.#.#.#.#####.#.#.###.#######.#.#.#.#
#...#...#.....#.#.#.#.#.#.........#.............#.#.....#.......#.#.#.....#.#.....#.#.......#.#.#.#.....#.#.#.#.....................#...#.#.#
#.#####.#######.#.#.#.#.#######.#.#.###########.#.#.###########.#.#.#######.#.#####.#######.#.#.#.#######.#.###.#.#.###.###.###.#########.#.#
#.#...#.......#.#.#...#.......#.................#.#...#.........#.#.......#.#.#...#.#.........#...#.......#...#...#...........#.#.......#.#.#
#.#.#.#####.#.#.#.###########.#.#.#.#.#.#.#.#####.###.#.#########.#######.#.#.#.#.#.#.###########.#####.#####.#####.#.#.#####.#.#.#####.#.#.#
#...#.......#.#.#...............#.#.#...#.#.........#.#...#.....#.......#...#.#.#...#...................#.#...#.........................#.#.#
#.#.###.#.#.#.#.#####.###.#######.#.#####.#######.###.###.#.###.#.#.#######.#.#.#######.#.#####.#.#####.#.#.###.#.#####.###.###.#####.#.#.#.#
#...#...#.#...#.#.....#...#.......#.....#.#.....#.#.....#.#...#.#.#...#...#.#.#.#.......#.....#.....#.....#.....#...............#.....#...#.#
###.#.#####.###.#.###.#.###.#.#####.#.###.#.###.#.#.###.#.#.#.#.###.#.#.#.#.#.#.#############.###.#.#.#.#############.###.#.#.###.#########.#
#.#.#.....#...#.#.#.#.#.#...#.#.#...#.#...#...#.#.#...#.#.#.#.#...#.#...#...#.#.....#.......#.#...#...#.......#.....#...#.#.#...#.....#.....#
#.#.#####.#.#.###.#.#.#.#####.#.#.###.#.#####.#.#####.#.#.###.###.###########.#.###.#.###.###.###.#####.###.###.#.#.###.#.#.###.#####.#####.#
#S......#.........#...#.......#.....#.........#.......#.......#...............#...#.....#.................#.......#.......#...#.............#
#############################################################################################################################################
